########################################
########################################
#                                      #
#                                      #
#                                      #
#                                      #
###########       ######################
#                                      #
#                                      #
#                                      #
#                                      #
#                                      #
#                                      #
#                                      #
#                                      #
#                                      #
#                                      #
#                                      #
#                                      #
#                                      #
#                                      #
#                                      #
############################       #####
#                                      #
#                                      #
#                                      #
#                                      #
#                                      #
#                                      #
########################################